66666666666666666666666666666666666
60000000000000000000000000000000006
60000000000000000000000000000000006
60000000000000005555500000000000006
60000000000000005555500000000000006
60000000000000005555500000000000006
60000000000000000000000000000000006
60000000000000000000000000000000006
66666666666666666666666666666666666
