66666666666666666666666666666
62111111111111111111111111126
61666666166666666666166666616
61111126111111111111162111116
61666616166666166666161666616
61111616111111111111161611116
61661616166666166666161616616
61111611111111111111111611116
61661616161665256616161616616
61111116161655555616161616616
61661616161655555616161111116
61661616161666666616161616616
61111611111111111111111611116
61661616166666166666161616616
61111616111111111111161611116
61666616166666166666161666616
61111126111111111111162111116
61666666166666666666166666616
62111111111111011111111111126
66666666666666666666666666666
